{
  "tileSet": "tile_set",
  "height": 32,
  "width": 32,
  "tileSize": 32,
  "tileSizeSrc": 40,
  "tileSetWidth": 3,
  "tiles": [
    [3,3,3,3,3,3,3,3,3,3,3,3,3,3,3,3,3,3,3,3,3,3,3,3,3,3,3,3,3,3,3,3],
    [3,3,3,3,3,3,1,1,1,2,2,3,3,3,1,1,1,3,3,3,3,3,1,1,1,3,3,3,3,3,3,3],
    [3,1,1,1,1,1,1,1,1,1,1,3,3,3,1,1,2,3,3,3,3,3,1,1,1,3,3,3,3,3,3,3],
    [3,1,1,1,1,1,1,1,1,1,1,3,3,3,1,1,1,3,3,3,3,3,1,1,1,1,1,1,1,1,1,3],
    [3,1,1,1,1,1,1,1,1,1,1,3,3,3,1,1,1,3,3,3,3,3,1,1,1,1,1,1,1,1,0,3],
    [3,1,1,3,3,3,3,3,1,1,1,3,3,3,1,1,1,1,1,1,1,1,1,1,1,1,1,1,1,1,1,3],
    [3,1,1,3,3,3,3,3,1,1,1,3,3,3,1,1,1,1,1,1,1,1,1,1,1,1,1,3,3,3,3,3],
    [3,1,1,3,3,3,3,3,1,1,1,1,1,1,1,1,1,1,1,1,1,1,1,1,1,1,1,3,3,3,3,3],
    [3,1,1,3,3,3,3,3,1,1,1,1,1,1,1,1,2,1,1,1,1,3,3,3,1,1,1,3,3,3,3,3],
    [3,1,1,3,3,3,3,3,3,1,1,1,1,1,1,1,2,1,1,1,1,3,3,3,1,1,1,3,3,3,3,3],
    [3,1,1,1,1,1,3,3,3,1,1,1,3,3,3,3,3,3,1,1,1,3,3,3,1,1,1,3,3,3,3,3],
    [3,1,1,1,1,1,3,3,3,1,1,1,3,3,3,3,3,3,1,1,1,3,3,3,1,1,1,1,1,1,1,3],
    [3,1,1,1,1,1,1,1,1,1,1,1,3,3,3,3,3,3,1,1,1,3,3,3,1,1,1,1,1,1,0,3],
    [3,3,3,1,1,1,1,1,1,1,1,1,3,3,3,3,3,3,1,1,1,3,3,3,1,1,1,1,1,1,1,3],
    [3,3,3,1,1,1,1,1,1,1,1,1,1,1,1,1,1,1,1,1,1,3,3,3,1,1,1,3,3,3,3,3],
    [3,3,3,1,1,1,3,3,3,1,1,1,1,1,1,1,1,1,1,2,1,3,3,3,1,1,1,3,3,3,3,3],
    [3,3,3,1,1,1,3,3,3,1,1,1,1,1,1,1,1,1,2,1,1,3,3,3,1,1,1,3,3,3,3,3],
    [3,3,3,1,1,1,3,3,3,1,1,1,3,3,3,3,3,3,1,1,1,3,3,3,1,1,1,3,3,3,3,3],
    [3,3,3,1,1,1,1,1,1,1,1,1,3,3,3,3,3,3,1,1,1,1,1,1,1,1,1,1,1,1,1,3],
    [3,3,3,1,1,1,1,1,1,1,1,1,3,3,3,3,3,3,1,1,1,1,1,1,1,1,1,1,1,1,1,3],
    [3,3,3,1,1,1,1,1,1,1,1,1,3,3,3,3,3,3,1,1,1,1,1,1,1,1,1,1,1,1,1,3],
    [3,3,3,1,1,1,3,3,3,1,1,1,3,3,3,3,3,3,1,1,1,1,3,3,3,3,1,1,1,3,3,3],
    [3,3,3,1,1,1,3,3,3,1,1,1,3,3,3,3,3,3,1,1,1,1,3,3,3,3,2,2,2,3,3,3],
    [3,1,1,1,1,1,3,3,3,1,1,1,1,1,1,2,1,1,1,1,1,1,3,3,3,3,1,1,1,3,3,3],
    [3,1,1,1,1,1,3,3,3,1,1,1,1,1,1,1,1,1,1,1,1,1,3,3,3,3,1,1,1,3,3,3],
    [3,1,1,1,1,1,3,3,3,2,1,1,1,1,1,1,1,1,1,1,1,1,1,1,1,1,1,1,1,3,3,3],
    [3,1,1,3,3,3,3,3,3,3,3,3,3,3,3,3,1,1,1,1,1,1,1,1,1,1,1,1,1,3,3,3],
    [3,1,1,3,3,3,3,3,3,3,3,3,3,3,3,3,1,1,1,1,1,1,2,1,1,1,1,1,1,3,3,3],
    [3,1,1,3,3,3,3,3,3,3,3,3,3,3,3,3,1,1,1,3,3,3,3,3,3,3,1,1,1,1,1,3],
    [3,1,1,3,3,3,3,3,3,3,3,3,3,3,3,3,1,1,1,3,3,3,3,3,3,3,1,1,1,1,1,3],
    [3,1,1,1,1,1,1,1,1,1,1,1,1,1,1,1,1,1,1,3,3,3,3,3,3,3,1,1,1,1,1,3],
    [3,3,3,3,3,3,3,3,3,3,3,3,3,3,3,3,3,3,3,3,3,3,3,3,3,3,3,3,3,3,3,3]
  ]
}